11111111111111111111
1P0000000000000000E1
10111101110111010101
10000C01000C00000001
11101101101101110111
1C0010000001000000C1
10111011111011111011
10000000000000000001
11110111010111010101
1C000C000000000C0001
10111101110111011111
10000000000000000001
11101101101101110111
1C000000C000000000C1
11101110111011101111
1C0000000000000000C1
10101110111011111011
1C0000000000000000C1
10111101110111010101
11111111111111111111
