1111111111
1C00000001
10000C0111
1P0000C0E1
1111111111