1111111
1P00001
1C0C0C1
10C0C01
10C0C01
10C0C01
10C0C01
10C0C01
10C0C01
10C0C01
10C0C01
10C0C01
10C0C01
10C0C01
1C0C0C1
10C0C01
1E00001
1111111