111111111111111111111111111111
1C01C001000000E0C00000E00000C1
10000011000000110000C000C00001
10011111001100CC111111111110C1
1C000C110011000000000C000000E1
111111111111111111111111111111