1111111111
1E00000001
10000C0001
1P0000C0E1
1111111111