1111111111111111
1P000000000000E1
1011110111011101
1C00000C00000001
1010111010111011
1C00000C00000001
1110111011111011
1C000000C0000001
1010111010111011
1C00000000C00001
1011110111011111
1C00000000000C01
1010111010111011
1C000000000000C1
1011110111011101
1111111111111111
