11111111111111111111
1P0000000000000000E1
10111101110111010101
1C00000C000000000001
10101110101110111111
1C00000C000000000001
11101110111110111111
1C000000C00000000001
10101110101110111111
1C00000000C000000001
10111101110111111111
1C00000000000C000001
10101110101110111111
1C0000000000000000C1
10111101110111010101
1C0000000000000000C1
10101110101110111111
1C0000000000000000C1
10111101110111010101
11111111111111111111
