11111
1P0E1
10101
1C0C1
11111
