1111111111111111111111111111111111111111111
1P00000000000000000000000000000000000000E01
1011111011111011111011101110111011101111011
1C00000C00000C00000C00000C00000C00000C00001
1011101011101011101011101011101011101011101
1C00001C00001C00001C00001C00001C00001C00001
1111011111011111011111011111011111011111011
1C000000000000000000C00000000000000000000C1
1011101110111011101110111011101110111011101
1C00000C00000C00000C00000C00000C00000C00001
1011111011111011111011101110111011101111011
1C00001C00001C00001C00001C00001C00001C00001
1011101011101011101011101011101011101011101
1C00000C00000C00000C00000C00000C00000C00001
1011111011111011111011101110111011101111011
1C00000000000000000000000000000000000000011
1111011111011111011111011111011111011111011
1C00000C00000C00000C00000C00000C00000C00011
1011101011101011101011101011101011101011101
1C00000000000000000000000000000000000000011
1011111011111011111011101110111011101111011
1111111111111111111111111111111111111111111
